%%%%%%%%%%%%%%%%%%%%%%%%%%%%%%%%%%%%%%%%%%%%%%%%%%%%%%%%%%%%%
%         % %........   %     %     ....  %...........%.....%
% %%%% %% % %.%%%%% %%%%% %%% % %%%%.%%.%%%.%% %% %%%.%.%.% %
% %     %   %.....%       %   %  .... %.....%   % % %...%.% %
% % %%% % %%%% %%.%%%%%%%%% %%%%%.%%% % %%% % % % % %%%%%.% %
% %   %   %.......%       %   ....%   %   % % % %     %...% %
% % %%% %%%.%%% %%% % %%% %%%%.%% % %%% % %%% % %%% %%%.%%% %
%   %     %.....%   % %........ % % %   %     %   % %...% % %
% %%% %%% %%%%%.%%%%% %.%%% %%% %%%%% %%%%%% %%%% %%%.%%% % %
%     %.......%.........% % %         %...%     %  ...%   % %
% %%%%%.%%%%%.%%%%%.%%%.% % % %%%%%%%%%.%.% %%% %%%.%%% %%% %
% %   %.%   %.......  %.%   % %     %  .%.% %.......    %   %
% % %%%.% %%% %%%%% % %.%%%%% % % %%% %.%.%%%.%%%%% %%%%% %%%
%   %...% %       % % %...%   % %   % %.%.....%     %   % % %
% %%%.%%% % % %%% %%% %%%.% %%% %%% % %.%%%%%%%%% %%% % % % %
% %...%   % %   %   % %...% %     %   %...%     % %   %   % %
%...%%% % % % % % % % %.%%% % %%%%%%% %%%.% %%% % % %%%%%%% %
%.%   % %   % %   %   %.%    .............% %   % % %       %
%.%%% %%% %%% %%% % %%%.% %%%.% %%%%%% %%%% % %%%%% % % %%% %
%...%         %   % %...% %...%         %   % %     % % %   %
%%%.%%% % %%%%% %%%%%.%%%%%.%%% %%%%%%% % %%% % %%%%%%% % %%%
%P..  %       %      .......%         %     %           %   %
%%%%%%%%%%%%%%%%%%%%%%%%%%%%%%%%%%%%%%%%%%%%%%%%%%%%%%%%%%%%%
