%%%%%%%%%%%%%%%%%%%%%%%%%%%%%%%%%%%%%%%%%%%%%%%%%
%~~  %   ~~~~~.%  ~~~~~~~~~  %  ~%     % %   %~~%
%~   %%%%~%%%%%% %~ % % %%~~~~~~~~~%%%%  %  %%%~%
%~   %~%~~  %~~% %~ % %  %   %  ~%~~~~~~~~~ %~~~%
%~~~~~~~~~~~~~~  %~~~   %%%% %  ~%%~~%%%~%~~~~  %
%~%%%%%~%%%%%%~ %%%%~%          ~~% ~  %~ %%%%%%%
%~~~   ~%~~~~%~~~~~~~~% %%%  %%%%%% ~% %~ %~~~% %
%%%~%% ~%~%%%%%%% %%%%% %    %~~~ %%~% %~~~~%~% %
%~~~ % ~%~     %  %      P% %%~ ~~~~~%  ~%%%%~% %
%~~~~~~~%~  %  %  %     %~~~~~~    %    ~~~~%~~~%
% % %%%~~~ % %    %% %% %%% %% %  % %%%%%%%%%%%~%
%   %~~~ %    %              %    %        ~~~~~%
%%%%%%%%%%%%%%%%%%%%%%%%%%%%%%%%%%%%%%%%%%%%%%%%%
