%%%%%%%%%%
% % ~~~% %
%~~%P%~  %
%~~~~~~~ %
%~%%%% % %
%.     % %
%%%%%%%%%%
