%%%%%%%%%%
%~~~% ~~~%
% %~% %%~%
% %~~~~%~%
% ~%P%~~~%
%~~~~ ~~~%
%~%%%%~%~%
%~~~~~~%.%
%%%%%%%%%%
