%%%%%%%%%%
%.  % .  %
% %.% %% %
% %   .%~%
% .%P% ~~%
%.  .  .~%
% %%%% %~%
%. .   %.%
%%%%%%%%%
